11111111111111111111111111
1CCCCCCCCCCC11CCCCCCCCCCC1
1C1111C1111C11C1111C1111C1
1C1111C1111C11C1111C1111C1
1C1111C1111C11C1111C1111C1
1CCCCVCCCCCCCCCCCCCCVCCCC1
1C111CC1C11111111C1CC111C1
1CCCCCC1CCCC11CCCC1CCCCCC1
1C1111C111101101111C1111C1
1C1111C1VV00P000VV1C1111C1
1C1111C101CCCCCC101C1111C1
1ECCCCC0VVCVVVVCVV0CCCCCC1
111111C101111111101C111111
111111C100000000001C111111
111111C101111111101C111111
1CCCCCCCCCCC11CCCCCCCCCCC1
11111111111111111111111111