11111111111111111111111111
1CCCCCCCCCCC11CCCCCCCCCCC1
1C1111C1111C11C1111C1111C1
1C1111C1111C11C1111C1111C1
1C1111V111111111111V1111C1
1CCCCVCCCCCCCCCCCCCCVCCCC1
1C111CC1C11111111C1CC111C1
1CCCCCC1CCCC11CCCC1CCCCCC1
1C1111C1111C11C1111C1111C1
1C1111C1VVVCVVCVVV1C1111C1
1C1111CCC1CCCCCC1CCC1111C1
1ECCCCCCCVCVVVVCVCCCCCCCC1
111111C1C11111111C1C111111
111111C1CCCCCPCCCC1C111111
111111C1C11111111C1C111111
1CCCCCCCCCCC11CCCCCCCCCCC1
11111111111111111111111111